width=30 height=15 tilewidth=32 tileheight=32
113311111111111111111111114541
112211111211111111111111114241
112211222222211122222221112221
112211222122211122222221112221
112211221112211122111221112221
112211221112222122111221112221
112211221112212122111221112221
112211221112212222111221112221
112211221112214122111221112221
112211221112211122141221112221
112211221112211122141221112221
112222221312222222141222222221
112222221212222222111222222221
111121111211111111111111111111
111122222211111111111111111111
