width=30 height=15 tilewidth=32 tileheight=32
113311111111111111111111114541
112211111111111111111111114241
112211222222211122222221112221
112211222222211122222221112221
112211221112211122111221112221
112211221112222122111221112221
112211221112212122111221112221
112211221112212222111221112221
112211221112214122111221112221
112211221112211122141221112221
112211221112211122141221112221
112222221112222222141222222221
112222221112222222111222222221
111111111111111111111111111111
111111111111111111111111111111
road // coordinate of the left/top cell
3,0 3,12 7,12 7,3 12,3 12,12 17,12 17,3 22,3 22,12 27,12 27,0
