width=15 height=15 tilewidth=32 tileheight=32
113311111111111
112211111111111
112211222222211
112211222222211
112211221112211
112211221112211
112211221112211
112211221112211
112211221112211
112211221112211
112211221112211
112222221112211
112222221112211
111111111115411
111111111114511
road // coordinate of the left/top cell
3,0 3,12 7,12 7,3 12,3 12,14
